53953B9553
BC696C4796
AFBABFFFC3
AFC4057F96
AFFFAFFF83
C53FAFD52A
93AFAFFFEA
AA83C3953A
AC6E96C3AA
85554556C6

0,0
9,0
ESENEESWSSESSSSESWSWWWW
